1	1	1	1	1	1	1	1	1	1	1	1	1	1	1	1	1	1	1	1	1	1	1	1	1	1	1	1	1	1	1	1	1	1	1	1	1	1	1	1	1	1	1	1	1	1	1	1	1	1	1	1	1	1	1	1	1	1	1	1	1	1	1	1
1	1	1	1	1	1	1	1	1	1	1	1	1	1	1	1	1	1	1	1	1	1	1	1	1	1	1	1	1	1	1	1	1	1	1	1	1	1	1	1	1	1	1	1	1	1	1	1	1	1	1	1	1	1	1	1	1	1	1	1	1	1	1	1
1	1	1	1	1	1	1	1	1	1	1	1	1	1	1	1	1	1	1	1	1	1	1	1	1	1	1	1	1	1	1	1	1	1	1	1	1	1	1	1	1	1	1	1	1	1	1	1	1	1	1	1	1	1	1	1	1	1	1	1	1	1	1	1
1	1	1	1	1	1	1	1	1	1	1	1	1	1	1	1	1	1	1	1	1	1	1	1	1	1	1	1	1	1	1	1	1	1	1	1	1	1	1	1	1	1	1	1	1	1	1	1	1	1	1	1	1	1	1	1	1	1	1	1	1	1	1	1
1	1	1	1	120	120	120	120	120	120	120	120	120	120	120	120	120	120	120	120	1	1	1	1	120	120	120	120	1	1	1	1	120	120	120	120	120	120	120	120	120	120	120	120	120	120	120	120	1	1	1	1	120	120	120	120	120	120	120	120	1	1	1	1
1	1	1	1	120	120	120	120	120	120	120	120	120	120	120	120	120	120	120	120	1	1	1	1	120	120	120	120	1	1	1	1	120	120	120	120	120	120	120	120	120	120	120	120	120	120	120	120	1	1	1	1	120	120	120	120	120	120	120	120	1	1	1	1
1	1	1	1	120	120	120	120	120	120	120	120	120	120	120	120	120	120	120	120	1	1	1	1	120	120	120	120	1	1	1	1	120	120	120	120	120	120	120	120	120	120	120	120	120	120	120	120	1	1	1	1	120	120	120	120	120	120	120	120	1	1	1	1
1	1	1	1	120	120	120	120	120	120	120	120	120	120	120	120	120	120	120	120	1	1	1	1	120	120	120	120	1	1	1	1	120	120	120	120	120	120	120	120	120	120	120	120	120	120	120	120	1	1	1	1	120	120	120	120	120	120	120	120	1	1	1	1
1	1	1	1	120	120	120	120	120	120	120	120	120	120	120	120	120	120	120	120	1	1	1	1	120	120	120	120	1	1	1	1	120	120	120	120	120	120	120	120	120	120	120	120	120	120	120	120	1	1	1	1	120	120	120	120	120	120	120	120	1	1	1	1
1	1	1	1	120	120	120	120	120	120	120	120	120	120	120	120	120	120	120	120	1	1	1	1	120	120	120	120	1	1	1	1	120	120	120	120	120	120	120	120	120	120	120	120	120	120	120	120	1	1	1	1	120	120	120	120	120	120	120	120	1	1	1	1
1	1	1	1	1	1	1	1	1	1	1	1	1	1	1	1	1	1	1	1	1	1	1	1	1	1	1	1	1	1	1	1	1	1	1	1	1	1	1	1	1	1	1	1	1	1	1	1	1	1	1	1	1	1	1	1	1	1	1	1	1	1	1	1
1	1	1	1	1	1	1	1	1	1	1	1	1	1	1	1	1	1	1	1	1	1	1	1	1	1	1	1	1	1	1	1	1	1	1	1	1	1	1	1	1	1	1	1	1	1	1	1	1	1	1	1	1	1	1	1	1	1	1	1	1	1	1	1
1	1	1	1	1	1	1	1	1	1	1	1	1	1	1	1	1	1	1	1	1	1	1	1	1	1	1	1	1	1	1	1	1	1	1	1	1	1	1	1	1	1	1	1	1	1	1	1	1	1	1	1	1	1	1	1	1	1	1	1	1	1	1	1
1	1	1	1	1	1	1	1	1	1	1	1	1	1	1	1	1	1	1	1	1	1	1	1	1	1	1	1	1	1	1	1	1	1	1	1	1	1	1	1	1	1	1	1	1	1	1	1	1	1	1	1	1	1	1	1	1	1	1	1	1	1	1	1
1	1	1	1	120	120	120	120	120	120	120	120	1	1	1	1	120	120	120	120	1	1	1	1	120	120	120	120	1	1	1	1	120	120	120	120	120	120	120	120	120	120	120	120	120	120	120	120	1	1	1	1	120	120	120	120	120	120	120	120	1	1	1	1
1	1	1	1	120	120	120	120	120	120	120	120	1	1	1	1	120	120	120	120	1	1	1	1	120	120	120	120	1	1	1	1	120	120	120	120	120	120	120	120	120	120	120	120	120	120	120	120	1	1	1	1	120	120	120	120	120	120	120	120	1	1	1	1
1	1	1	1	120	120	120	120	120	120	120	120	1	1	1	1	120	120	120	120	1	1	1	1	120	120	120	120	1	1	1	1	120	120	120	120	120	120	120	120	120	120	120	120	120	120	120	120	1	1	1	1	120	120	120	120	120	120	120	120	1	1	1	1
1	1	1	1	120	120	120	120	120	120	120	120	1	1	1	1	120	120	120	120	1	1	1	1	120	120	120	120	1	1	1	1	120	120	120	120	120	120	120	120	120	120	120	120	120	120	120	120	1	1	1	1	120	120	120	120	120	120	120	120	1	1	1	1
1	1	1	1	120	120	120	120	120	120	120	120	1	1	1	1	120	120	120	120	1	1	1	1	120	120	120	120	1	1	1	1	120	120	120	120	120	120	120	120	120	120	120	120	120	120	120	120	1	1	1	1	120	120	120	120	120	120	120	120	1	1	1	1
1	1	1	1	120	120	120	120	120	120	120	120	1	1	1	1	120	120	120	120	1	1	1	1	120	120	120	120	1	1	1	1	120	120	120	120	120	120	120	120	120	120	120	120	120	120	120	120	1	1	1	1	120	120	120	120	120	120	120	120	1	1	1	1
1	1	1	1	120	120	120	120	120	120	120	120	1	1	1	1	120	120	120	120	1	1	1	1	120	120	120	120	1	1	1	1	120	120	120	120	120	120	120	120	120	120	120	120	120	120	120	120	1	1	1	1	120	120	120	120	120	120	120	120	1	1	1	1
1	1	1	1	120	120	120	120	120	120	120	120	1	1	1	1	120	120	120	120	1	1	1	1	120	120	120	120	1	1	1	1	120	120	120	120	120	120	120	120	120	120	120	120	120	120	120	120	1	1	1	1	120	120	120	120	120	120	120	120	1	1	1	1
1	1	1	1	120	120	120	120	120	120	120	120	1	1	1	1	120	120	120	120	1	1	1	1	120	120	120	120	1	1	1	1	120	120	120	120	120	120	120	120	120	120	120	120	120	120	120	120	1	1	1	1	120	120	120	120	120	120	120	120	1	1	1	1
1	1	1	1	120	120	120	120	120	120	120	120	1	1	1	1	120	120	120	120	1	1	1	1	120	120	120	120	1	1	1	1	120	120	120	120	120	120	120	120	120	120	120	120	120	120	120	120	1	1	1	1	120	120	120	120	120	120	120	120	1	1	1	1
1	1	1	1	120	120	120	120	120	120	120	120	1	1	1	1	120	120	120	120	1	1	1	1	120	120	120	120	1	1	1	1	120	120	120	120	120	120	120	120	120	120	120	120	120	120	120	120	1	1	1	1	120	120	120	120	120	120	120	120	1	1	1	1
1	1	1	1	120	120	120	120	120	120	120	120	1	1	1	1	120	120	120	120	1	1	1	1	120	120	120	120	1	1	1	1	120	120	120	120	120	120	120	120	120	120	120	120	120	120	120	120	1	1	1	1	120	120	120	120	120	120	120	120	1	1	1	1
1	1	1	1	1	1	1	1	1	1	1	1	1	1	1	1	1	1	1	1	1	1	1	1	1	1	1	1	1	1	1	1	1	1	1	1	1	1	1	1	1	1	1	1	1	1	1	1	1	1	1	1	1	1	1	1	1	1	1	1	1	1	1	1
1	1	1	1	1	1	1	1	1	1	1	1	1	1	1	1	1	1	1	1	1	1	1	1	1	1	1	1	1	1	1	1	1	1	1	1	1	1	1	1	1	1	1	1	1	1	1	1	1	1	1	1	1	1	1	1	1	1	1	1	1	1	1	1
1	1	1	1	1	1	1	1	1	1	1	1	1	1	1	1	1	1	1	1	1	1	1	1	1	1	1	1	1	1	1	1	1	1	1	1	1	1	1	1	1	1	1	1	1	1	1	1	1	1	1	1	1	1	1	1	1	1	1	1	1	1	1	1
1	1	1	1	1	1	1	1	1	1	1	1	1	1	1	1	1	1	1	1	1	1	1	1	1	1	1	1	1	1	1	1	1	1	1	1	1	1	1	1	1	1	1	1	1	1	1	1	1	1	1	1	1	1	1	1	1	1	1	1	1	1	1	1
1	1	1	1	120	120	120	120	120	120	120	120	1	1	1	1	120	120	120	120	1	1	1	1	120	120	120	120	1	1	1	1	120	120	120	120	120	120	120	120	120	120	120	120	120	120	120	120	1	1	1	1	120	120	120	120	120	120	120	120	1	1	1	1
1	1	1	1	120	120	120	120	120	120	120	120	1	1	1	1	120	120	120	120	1	1	1	1	120	120	120	120	1	1	1	1	120	120	120	120	120	120	120	120	120	120	120	120	120	120	120	120	1	1	1	1	120	120	120	120	120	120	120	120	1	1	1	1
1	1	1	1	120	120	120	120	120	120	120	120	1	1	1	1	120	120	120	120	1	1	1	1	120	120	120	120	1	1	1	1	120	120	120	120	120	120	120	120	120	120	120	120	120	120	120	120	1	1	1	1	120	120	120	120	120	120	120	120	1	1	1	1
1	1	1	1	120	120	120	120	120	120	120	120	1	1	1	1	120	120	120	120	1	1	1	1	120	120	120	120	1	1	1	1	120	120	120	120	120	120	120	120	120	120	120	120	120	120	120	120	1	1	1	1	120	120	120	120	120	120	120	120	1	1	1	1
1	1	1	1	120	120	120	120	120	120	120	120	1	1	1	1	120	120	120	120	1	1	1	1	120	120	120	120	1	1	1	1	120	120	120	120	120	120	120	120	120	120	120	120	120	120	120	120	1	1	1	1	120	120	120	120	120	120	120	120	1	1	1	1
1	1	1	1	120	120	120	120	120	120	120	120	1	1	1	1	120	120	120	120	1	1	1	1	120	120	120	120	1	1	1	1	120	120	120	120	120	120	120	120	120	120	120	120	120	120	120	120	1	1	1	1	120	120	120	120	120	120	120	120	1	1	1	1
1	1	1	1	120	120	120	120	120	120	120	120	1	1	1	1	120	120	120	120	1	1	1	1	120	120	120	120	1	1	1	1	120	120	120	120	120	120	120	120	120	120	120	120	120	120	120	120	1	1	1	1	120	120	120	120	120	120	120	120	1	1	1	1
1	1	1	1	120	120	120	120	120	120	120	120	1	1	1	1	120	120	120	120	1	1	1	1	120	120	120	120	1	1	1	1	120	120	120	120	120	120	120	120	120	120	120	120	120	120	120	120	1	1	1	1	120	120	120	120	120	120	120	120	1	1	1	1
1	1	1	1	120	120	120	120	120	120	120	120	1	1	1	1	120	120	120	120	1	1	1	1	120	120	120	120	1	1	1	1	120	120	120	120	120	120	120	120	120	120	120	120	120	120	120	120	1	1	1	1	120	120	120	120	120	120	120	120	1	1	1	1
1	1	1	1	120	120	120	120	120	120	120	120	1	1	1	1	120	120	120	120	1	1	1	1	120	120	120	120	1	1	1	1	120	120	120	120	120	120	120	120	120	120	120	120	120	120	120	120	1	1	1	1	120	120	120	120	120	120	120	120	1	1	1	1
1	1	1	1	120	120	120	120	120	120	120	120	1	1	1	1	120	120	120	120	1	1	1	1	120	120	120	120	1	1	1	1	120	120	120	120	120	120	120	120	120	120	120	120	120	120	120	120	1	1	1	1	120	120	120	120	120	120	120	120	1	1	1	1
1	1	1	1	120	120	120	120	120	120	120	120	1	1	1	1	120	120	120	120	1	1	1	1	120	120	120	120	1	1	1	1	120	120	120	120	120	120	120	120	120	120	120	120	120	120	120	120	1	1	1	1	120	120	120	120	120	120	120	120	1	1	1	1
1	1	1	1	120	120	120	120	120	120	120	120	1	1	1	1	120	120	120	120	1	1	1	1	120	120	120	120	1	1	1	1	120	120	120	120	120	120	120	120	120	120	120	120	120	120	120	120	1	1	1	1	120	120	120	120	120	120	120	120	1	1	1	1
1	1	1	1	120	120	120	120	120	120	120	120	1	1	1	1	120	120	120	120	1	1	1	1	120	120	120	120	1	1	1	1	120	120	120	120	120	120	120	120	120	120	120	120	120	120	120	120	1	1	1	1	120	120	120	120	120	120	120	120	1	1	1	1
1	1	1	1	120	120	120	120	120	120	120	120	1	1	1	1	120	120	120	120	1	1	1	1	120	120	120	120	1	1	1	1	120	120	120	120	120	120	120	120	120	120	120	120	120	120	120	120	1	1	1	1	120	120	120	120	120	120	120	120	1	1	1	1
1	1	1	1	120	120	120	120	120	120	120	120	1	1	1	1	120	120	120	120	1	1	1	1	120	120	120	120	1	1	1	1	120	120	120	120	120	120	120	120	120	120	120	120	120	120	120	120	1	1	1	1	120	120	120	120	120	120	120	120	1	1	1	1
1	1	1	1	120	120	120	120	120	120	120	120	1	1	1	1	120	120	120	120	1	1	1	1	120	120	120	120	1	1	1	1	120	120	120	120	120	120	120	120	120	120	120	120	120	120	120	120	1	1	1	1	120	120	120	120	120	120	120	120	1	1	1	1
1	1	1	1	120	120	120	120	120	120	120	120	1	1	1	1	120	120	120	120	1	1	1	1	120	120	120	120	1	1	1	1	120	120	120	120	120	120	120	120	120	120	120	120	120	120	120	120	1	1	1	1	120	120	120	120	120	120	120	120	1	1	1	1
1	1	1	1	120	120	120	120	120	120	120	120	1	1	1	1	120	120	120	120	1	1	1	1	120	120	120	120	1	1	1	1	120	120	120	120	120	120	120	120	120	120	120	120	120	120	120	120	1	1	1	1	120	120	120	120	120	120	120	120	1	1	1	1
1	1	1	1	120	120	120	120	120	120	120	120	1	1	1	1	120	120	120	120	1	1	1	1	120	120	120	120	1	1	1	1	120	120	120	120	120	120	120	120	120	120	120	120	120	120	120	120	1	1	1	1	120	120	120	120	120	120	120	120	1	1	1	1
1	1	1	1	1	1	1	1	1	1	1	1	1	1	1	1	1	1	1	1	1	1	1	1	1	1	1	1	1	1	1	1	1	1	1	1	1	1	1	1	1	1	1	1	1	1	1	1	1	1	1	1	1	1	1	1	1	1	1	1	1	1	1	1
1	1	1	1	1	1	1	1	1	1	1	1	1	1	1	1	1	1	1	1	1	1	1	1	1	1	1	1	1	1	1	1	1	1	1	1	1	1	1	1	1	1	1	1	1	1	1	1	1	1	1	1	1	1	1	1	1	1	1	1	1	1	1	1
1	1	1	1	1	1	1	1	1	1	1	1	1	1	1	1	1	1	1	1	1	1	1	1	1	1	1	1	1	1	1	1	1	1	1	1	1	1	1	1	1	1	1	1	1	1	1	1	1	1	1	1	1	1	1	1	1	1	1	1	1	1	1	1
1	1	1	1	1	1	1	1	1	1	1	1	1	1	1	1	1	1	1	1	1	1	1	1	1	1	1	1	1	1	1	1	1	1	1	1	1	1	1	1	1	1	1	1	1	1	1	1	1	1	1	1	1	1	1	1	1	1	1	1	1	1	1	1
1	1	1	1	120	120	120	120	120	120	120	120	120	120	120	120	120	120	120	120	120	120	120	120	120	120	120	120	120	120	120	120	120	120	120	120	120	120	120	120	120	120	120	120	120	120	120	120	120	120	120	120	120	120	120	120	120	120	120	120	1	1	1	1
1	1	1	1	120	120	120	120	120	120	120	120	120	120	120	120	120	120	120	120	120	120	120	120	120	120	120	120	120	120	120	120	120	120	120	120	120	120	120	120	120	120	120	120	120	120	120	120	120	120	120	120	120	120	120	120	120	120	120	120	1	1	1	1
1	1	1	1	120	120	120	120	120	120	120	120	120	120	120	120	120	120	120	120	120	120	120	120	120	120	120	120	120	120	120	120	120	120	120	120	120	120	120	120	120	120	120	120	120	120	120	120	120	120	120	120	120	120	120	120	120	120	120	120	1	1	1	1
1	1	1	1	120	120	120	120	120	120	120	120	120	120	120	120	120	120	120	120	120	120	120	120	120	120	120	120	120	120	120	120	120	120	120	120	120	120	120	120	120	120	120	120	120	120	120	120	120	120	120	120	120	120	120	120	120	120	120	120	1	1	1	1
1	1	1	1	1	1	1	1	1	1	1	1	1	1	1	1	1	1	1	1	1	1	1	1	1	1	1	1	1	1	1	1	1	1	1	1	1	1	1	1	1	1	1	1	1	1	1	1	1	1	1	1	1	1	1	1	1	1	1	1	1	1	1	1
1	1	1	1	1	1	1	1	1	1	1	1	1	1	1	1	1	1	1	1	1	1	1	1	1	1	1	1	1	1	1	1	1	1	1	1	1	1	1	1	1	1	1	1	1	1	1	1	1	1	1	1	1	1	1	1	1	1	1	1	1	1	1	1
1	1	1	1	1	1	1	1	1	1	1	1	1	1	1	1	1	1	1	1	1	1	1	1	1	1	1	1	1	1	1	1	1	1	1	1	1	1	1	1	1	1	1	1	1	1	1	1	1	1	1	1	1	1	1	1	1	1	1	1	1	1	1	1
1	1	1	1	1	1	1	1	1	1	1	1	1	1	1	1	1	1	1	1	1	1	1	1	1	1	1	1	1	1	1	1	1	1	1	1	1	1	1	1	1	1	1	1	1	1	1	1	1	1	1	1	1	1	1	1	1	1	1	1	1	1	1	1
1	1	1	1	1	1	1	1	1	1	1	1	1	1	1	1	1	1	1	1	1	1	1	1	1	1	1	1	1	1	1	1	1	1	1	1	1	1	1	1	1	1	1	1	1	1	1	1	1	1	1	1	1	1	1	1	1	1	1	1	1	1	1	1
1	1	1	1	1	1	1	1	1	1	1	1	1	1	1	1	1	1	1	1	1	1	1	1	1	1	1	1	1	1	1	1	1	1	1	1	1	1	1	1	1	1	1	1	1	1	1	1	1	1	1	1	1	1	1	1	1	1	1	1	1	1	1	1